#####################################################
#    ##   ###################      #############    #
# ######   ##          #########          ##   #### #
#         #     ######     ###  #  #####  ###       #
# ##### ##### ##########    #    #              #  ##
# #    #    ###   #######   #  ###  ###   ###      ##
#      ##  #####   #  #     #        #            ###
##   # #           #  #  #########   # #   ###     ##
###### ###   ###      #  #  #      # #           #  #
#      #     #  #   #    #  #     ###   #        ## #
#### ##########    #     #  #   ###    #    #    #  #
#      #          ####      #         ######     # ##
# ########## #   #########  # #   ###         #  #  #
#   #   #  #       #        #  #     #    #      ## #
# #    #   # #     #  #  #    #   ###     #    #### #
#   #      #   #   #  #  #     #     #### #   ###   #
# #    #   #   #   ## ###      ####  #    #        ##
# #      #     #   #   #   #              ######    #
# #  ### #   ###   # # # # #### #####  #  #   ###   #
# ##########################         #    #    ###  #
# #  ### ########### # # # #   ####   ### #        ##
#    ##      ####### # # #             ######### ####
####     #       ###       #  ######     ###        #
#####################################################