#####################################################
#                                                   #
# ######   ##                            ##   #     #
#         #     ###                       ###       #
# ##### ##### ##########                            #
# #   # #          #            ###  ###   ###      #
#      #           #                              # #
#      #           #                       ###      #
#       #    #    #                                 #
#      #            #                   #           #
#      #           #            ###    #    #       #
#      #          #                   #    #        #
# ##########     #########           #    #  ###    #
#          #       #                 #    #         #
#          # #     #     #           #    #     ### #
#    #     #       #     #           #              #
#      #   #       ##########        #    #         #
# #                #   #   #   ###############      #
# #                # # # # #         #    #         #
# #                # # # # #         #    #    ###  #
# #                # # # # #              #         #
#                  # # # # #       ###    #         #
#                    #   #                #         #
#####################################################