#####################################################
#                                                   #
# ######   ##          #########          ##   #    #
#         #     ###                       ###       #
# ##### ##### ##########                            #
# #   # #          #            ###  ###   ###      #
#      #           #                              # #
#      #           #     #########     #   ###      #
#       #    #    #                                 #
#      #            #                   #           #
#      #           #            ###    #    #       #
#      #          #                   #    #        #
# ##########     #########           #    #  ###    #
#          #       #                 #    #         #
#          # #     #     #           #    #     ### #
#    #     #       #     #           #              #
#      #   #       ##########        #    #         #
# #      #         #   #   #   ###############      #
# #      #         # # # # #         #    #         #
# #  ##########    # # # # #         #    #    ###  #
# #      #         # # # # #              #         #
#                  # # # # #       ###    #         #
#        #           #   #                #         #
#####################################################