#####################################################
#         ################                          #
# ######   ##          #########          ##   #    #
#         #     ###                #####  ###       #
# ##### ##### ##########                           ##
# #    #          #            ###  ###   ###      ##
#      #   #####   #                              ###
##     #           #     #########     #   ###     ##
#### #####                                          #
#      #        #   #                   #           #
#                  #            ###    #    #       #
#      #          #                   #    #        #
# ##########     #########    #               #     #
#          #       #           #     #    #         #
#          # #     #     #        ###          ######
#    #     #       #     #     #     #              #
#      #   #       ##########  #     #    #         #
# #      #         #   #   #              #####     #
# #      #         #   #   #    #####               #
# #############                      #    #    ###  #
# #      #         # # # # #   #          #         #
#        #                                          #
#        #           #   #  #    #####    #         #
#####################################################