#####################################################
#         ################         #############    #
# ######   ##          #########          ##   #    #
#         #     ######             #####  ###       #
# ##### ##### ##########                        #  ##
# #    #          #######      ###  ###   ###      ##
#      ##  #####   #                              ###
##     #           #     #########     #   ###     ##
#### #####                  #      #             #  #
#      #        #   #       #           #        ## #
#### #########     #        #   ###    #    #    #  #
#      #          #         #         #    #     # ##
# ########## #   #########  # #               #  #  #
#   #   #  #       #        #  #     #    #      ## #
# #    #   # #     #     #    #   ###          #### #
#   #      #   #   #     #     #     #        ###   #
#      #   #   #   ## ###      #     #    #         #
# #      #     #   #   #   #              #####     #
# #      #   ###   # # # # #    #####         ###   #
# ##########################         #    #    ###  #
# #      #         # # # # #   #      ### #         #
#   ###      ####### # # #             ######### ####
####     #           #     #  ######     ###        #
#####################################################