#####################################################
#    ##   ###################      #############    #
# ######   ##          #########          ##   #### #
#         #     ######     ###     #####  ###       #
# ##### ##### ##########    #                   #  ##
# #    #    ###   #######   #  ###  ###   ###      ##
#      ##  #####   #        #                     ###
##     #           #     #########     #   ###     ##
#### #####   ###         #  #      #             #  #
#      #        #   #    #  #     ###   #        ## #
#### #########     #     #  #   ###    #    #    #  #
#      #          ####      #         #    #     # ##
# ########## #   #########  # #   ###         #  #  #
#   #   #  #       #        #  #     #    #      ## #
# #    #   # #     #  #  #    #   ###          #### #
#   #      #   #   #  #  #     #     ####     ###   #
#      #   #   #   ## ###      ####  #    #         #
# #      #     #   #   #   #              #####     #
# #  ### #   ###   # # # # #### #####         ###   #
# ##########################         #    #    ###  #
# #  ### ########### # # # #   ####   ### #         #
#    ##      ####### # # #             ######### ####
####     #       ###       #  ######     ###        #
#####################################################