#####################################################
#                                                   #
# #                                       ###       #
# #   #                                             #
# # ########## ##########                           #
# #  #           #            ###  ###   ###        #
# #              #                              ### #
# #              #                       ###        #
# #     #    #   #                                  #
# #              #                   #              #
# #              #            ###    #    #         #
# #              #                   #    #         #
# ##########     #########           #    #  ###    #
#          #       #                 #    #         #
#          # #     #     #           #    #     ### #
#    #     #       #     #           #              #
#      #   #       ##########        #    #         #
# #                #   #   #   ###############      #
# #                # # # # #         #    #         #
# #                # # # # #         #    #    ###  #
# #                # # # # #              #         #
#                  # # # # #       ###    #         #
#                    #   #                #         #
#####################################################
