#####################################################
#         ################                          #
# ######   ##          #########          ##   #    #
#         #     ###                       ###       #
# ##### ##### ##########                           ##
# #    #          #            ###  ###   ###      ##
#      #           #                              ###
##     #           #     #########     #   ###     ##
#### #####                                          #
#      #        #   #                   #           #
#                  #            ###    #    #       #
#      #          #                   #    #        #
# ##########     #########     #     #    #  ###    #
#          #       #           #     #    #         #
#          # #     #     #     #     #    #     ### #
#    #     #       #     #     #     #              #
#      #   #       ##########  #     #    #         #
# #      #         #   #   #   ###############      #
# #      #         #   #   #   #     #    #         #
# #  ##########                      #    #    ###  #
# #      #         # # # # #   #          #         #
#                               #  ###    #         #
#        #           #   #  #             #         #
#####################################################