#####################################################
#         ################         #############    #
# ######   ##          #########          ##   #    #
#         #     ###                #####  ###       #
# ####  ##### ##########                        #  ##
# #    #          #            ###  ###   ###      ##
#      #   #####   #                              ###
##     #           #     #########     #   ###     ##
#### #####                                       #  #
#      #        #   #                   #        #  #
#### #########     #            ###    #    #    #  #
#      #          #                   #    #     #  #
# ##########     #########    #               #  #  #
#   #   #  #       #           #     #    #      #  #
# #    #   # #     #     #        ###          #### #
#   #      #       #     #     #     #              #
#      #   #       ## ###      #     #    #         #
# #      #         #   #   #              #####     #
# #      #         # # # # #    #####               #
# ##########################         #    #    ###  #
# #      #         # # # # #   #          #         #
#            ####### # # #             ##############
#        #           #     #  ######                #
#####################################################