#####################################################
#         ################         #############    #
# ######   ##          #########          ##   #### #
#         #     ######     ###     #####  ###       #
# ##### ##### ##########    #                   #  ##
# #    #          #######   #  ###  ###   ###      ##
#      ##  #####   #        #                     ###
##     #           #     #########     #   ###     ##
#### #####   ###         #  #      #             #  #
#      #        #   #    #  #     ###   #        ## #
#### #########     #     #  #   ###    #    #    #  #
#      #          ####      #         #    #     # ##
# ########## #   #########  # #   ###         #  #  #
#   #   #  #       #        #  #     #    #      ## #
# #    #   # #     #  #  #    #   ###          #### #
#   #      #   #   #  #  #     #     #        ###   #
#      #   #   #   ## ###      #     #    #         #
# #      #     #   #   #   #              #####     #
# #  ### #   ###   # # # # #### #####         ###   #
# ##########################         #    #    ###  #
# #      #      #### # # # #   #      ### #         #
#   ###      ####### # # #             ######### ####
####     #           #     #  ######     ###        #
#####################################################